G...................
.#................#.
...1................
....................
.........H..........
..#.............#.2.
....................
.........P..........
.H......###.......S.
........#T#.........
....................
....................
.........S..........
....................
...#..1........#....
....................
....................
....................
.#...............#..
..........1........s