...................G
.#.......2........#.
....................
....................
......#..H..#.......
......#.###.#.......
....................
.........P..........
.H......###.......S.
........#T#.........
....................
....................
....#.....S...#.....
....#.........#.....
....###########.....
........1...........
....................
....................
.#...............#..
.........1.........G